Planets
{
		asgard = "Asgardian"
		alers = "Alers"
		caipulia = "Caipulia"
		eirio = "Eirio"
		hole = "Black Hole"
		krats = "Krats"
		miriners = "Miriners"
		mooran = "Mooran"
		oori = "Oori"
		rionrs = "Rionrs"
		shierans = "Shierans"
		stiff = "Stiff"
		sunblue = "Blue Sun"
		sunred = "Red Sun"
		sungreen = "Green Sun"
		vesper = "Vesper"
		xiurina = "Xiurina"
		zuo = "Zuo"

		sun = "Orange Sun"
		alien = "Alien"
		desert = "Desert"
		gas = "Gassy"
		icy = "Icy"
		lava = "Lava"
		terra = "Terra"
}
MapSizes
{
		Planetary = "Planetary Galaxy"
		PlanetaryTip = "A Galaxy Generated By The Planetary Mod"
}